//Easy Map
{0,0,0,0,0,0,0,0,0,0,0,0,0,0,0,0,0,0,0,0,0,0}, {0,0,1,1,1,1,1,1,1,1,1,1,1,1,1,1,1,1,1,0,0,0}, {0,0,1,0,0,0,0,0,0,0,0,0,0,0,0,0,0,0,1,0,0,0}, 
{0,0,1,0,0,1,1,1,1,1,1,1,1,1,1,1,1,1,1,0,0,0}, {0,0,1,0,0,1,0,0,0,0,0,0,0,0,0,0,0,0,0,0,0,0}, {0,0,1,0,0,1,0,1,1,1,1,1,1,1,1,1,1,1,1,1,1,1}, 
{0,0,1,0,0,1,0,1,0,0,0,0,0,0,0,0,0,0,0,0,0,0}, {1,1,1,0,0,1,0,1,1,1,1,1,1,1,1,1,1,1,0,0,0,0}, {0,0,0,0,0,1,0,0,0,0,0,0,0,0,0,0,0,1,0,0,0,0},
{0,0,0,0,0,1,1,1,1,1,1,1,1,1,1,1,1,1,0,0,0,0}, {0,0,0,0,0,0,0,0,0,0,0,0,0,0,0,0,0,0,0,0,0,0}

//Medium Map
{0,0,0,0,0,0,0,0,0,0,0,0,0,0,0,0,0,0,0,0,0,0}
{0,0,1,1,1,1,1,0,0,0,0,0,0,0,0,0,0,0,0,0,0,0}
{0,0,1,0,0,0,1,0,0,0,0,0,0,0,0,0,0,0,0,0,0,0}
{0,0,1,0,0,0,1,0,0,0,0,1,1,1,1,0,0,0,0,0,0,0}
{0,0,1,0,0,0,1,0,0,0,0,1,0,0,1,0,0,0,0,0,0,0}
{0,0,1,0,0,0,1,0,0,0,0,1,0,0,1,0,0,0,0,0,0,0}
{0,0,1,0,0,0,1,1,1,0,0,1,0,0,1,1,1,1,1,1,1,1}
{0,0,1,0,0,0,0,0,1,0,0,1,0,0,0,0,0,0,0,0,0,0}
{0,0,1,0,0,0,0,0,1,0,0,1,0,0,0,0,0,0,0,0,0,0}
{1,1,1,0,0,0,0,0,1,1,1,1,0,0,0,0,0,0,0,0,0,0}
{0,0,0,0,0,0,0,0,0,0,0,0,0,0,0,0,0,0,0,0,0,0}

//Hard Map
{0,0,0,0,0,0,0,0,0,0,0,0,0,0,0,0,0,0,0,0,0,0}
{1,1,1,1,1,0,0,0,0,0,0,0,0,0,0,0,0,0,0,0,0,0}
{0,0,0,0,1,0,0,0,0,0,0,0,0,0,0,0,0,0,0,0,0,0}
{0,0,0,0,1,0,0,0,0,0,0,0,0,0,0,0,0,0,0,0,0,0}
{0,0,0,0,1,0,0,0,0,0,0,0,0,0,0,0,0,0,0,0,0,0}
{0,0,0,0,1,0,0,0,0,0,1,1,1,1,1,0,0,0,0,0,0,0}
{0,0,0,0,1,0,0,0,0,0,1,0,0,0,1,1,1,1,1,1,1,1}
{0,0,0,0,1,1,1,1,1,1,1,0,0,0,0,0,0,0,0,0,0,0}
{0,0,0,0,0,0,0,0,0,0,0,0,0,0,0,0,0,0,0,0,0,0}
{0,0,0,0,0,0,0,0,0,0,0,0,0,0,0,0,0,0,0,0,0,0}
{0,0,0,0,0,0,0,0,0,0,0,0,0,0,0,0,0,0,0,0,0,0}


//easy
{ {0,0,0,0,0,0,0,0,0,0,0,0,0,0,0,0,0,0,0,0,0,0}, 
    {0,0,2,2,2,2,2,2,2,2,2,2,2,2,2,2,2,2,4,0,0,0}, {0,0,3,0,0,0,0,0,0,0,0,0,0,0,0,0,0,0,4,0,0,0}, 
    {0,0,3,0,0,1,1,1,1,1,1,1,1,1,1,1,1,1,4,0,0,0}, {0,0,3,0,0,4,0,0,0,0,0,0,0,0,0,0,0,0,0,0,0,0}, 
    {0,0,3,0,0,4,0,2,2,2,2,2,2,2,2,2,2,2,2,2,2,2}, {0,0,3,0,0,4,0,3,0,0,0,0,0,0,0,0,0,0,0,0,0,0}, 
    {2,2,3,0,0,4,0,1,1,1,1,1,1,1,1,1,1,3,0,0,0,0}, {0,0,0,0,0,4,0,0,0,0,0,0,0,0,0,0,0,3,0,0,0,0},
    {0,0,0,0,0,2,2,2,2,2,2,2,2,2,2,2,2,3,0,0,0,0}, {0,0,0,0,0,0,0,0,0,0,0,0,0,0,0,0,0,0,0,0,0,0} }

private int[][] medium = {{0,0,0,0,0,0,0,0,0,0,0,0,0,0,0,0,0,0,0,0,0,0},
    {0,0,2,2,2,2,4,0,0,0,0,0,0,0,0,0,0,0,0,0,0,0}, {0,0,3,0,0,0,4,0,0,0,0,0,0,0,0,0,0,0,0,0,0,0},
    {0,0,3,0,0,0,4,0,0,0,0,2,2,2,4,0,0,0,0,0,0,0}, {0,0,3,0,0,0,4,0,0,0,0,3,0,0,4,0,0,0,0,0,0,0}, 
    {0,0,3,0,0,0,4,0,0,0,0,3,0,0,4,0,0,0,0,0,0,0}, {0,0,3,0,0,0,2,2,4,0,0,3,0,0,2,2,2,2,2,2,2,2}, 
    {0,0,3,0,0,0,0,0,4,0,0,3,0,0,0,0,0,0,0,0,0,0}, {0,0,3,0,0,0,0,0,4,0,0,3,0,0,0,0,0,0,0,0,0,0}, 
    {2,2,3,0,0,0,0,0,2,2,2,3,0,0,0,0,0,0,0,0,0,0}, {0,0,0,0,0,0,0,0,0,0,0,0,0,0,0,0,0,0,0,0,0,0}};
  
  private int[][] hard = {{0,0,0,0,0,0,0,0,0,0,0,0,0,0,0,0,0,0,0,0,0,0}, {0,0,0,0,0,0,0,0,0,0,0,0,0,0,0,0,0,0,0,0,0,0},
    {2,2,2,2,4,0,0,0,0,0,0,0,0,0,0,0,0,0,0,0,0,0},
    {0,0,0,0,4,0,0,0,0,0,0,0,0,0,0,0,0,0,0,0,0,0}, {0,0,0,0,4,0,0,0,0,0,0,0,0,0,0,0,0,0,0,0,0,0},
    {0,0,0,0,4,0,0,0,0,0,0,0,0,0,0,0,0,0,0,0,0,0}, {0,0,0,0,4,0,0,0,0,0,2,2,2,2,4,0,0,0,0,0,0,0},
    {0,0,0,0,4,0,0,0,0,0,3,0,0,0,2,2,2,2,2,2,2,2}, {0,0,0,0,2,2,2,2,2,2,3,0,0,0,0,0,0,0,0,0,0,0}, 
    {0,0,0,0,0,0,0,0,0,0,0,0,0,0,0,0,0,0,0,0,0,0}, {0,0,0,0,0,0,0,0,0,0,0,0,0,0,0,0,0,0,0,0,0,0},
    {0,0,0,0,0,0,0,0,0,0,0,0,0,0,0,0,0,0,0,0,0,0}};
