//Easy Map
{0,0,0,0,0,0,0,0,0,0,0,0,0,0,0,0,0,0,0,0,0,0}, {0,0,1,1,1,1,1,1,1,1,1,1,1,1,1,1,1,1,1,0,0,0}, {0,0,1,0,0,0,0,0,0,0,0,0,0,0,0,0,0,0,1,0,0,0}, 
{0,0,1,0,0,1,1,1,1,1,1,1,1,1,1,1,1,1,1,0,0,0}, {0,0,1,0,0,1,0,0,0,0,0,0,0,0,0,0,0,0,0,0,0,0}, {0,0,1,0,0,1,0,1,1,1,1,1,1,1,1,1,1,1,1,1,1,1}, 
{0,0,1,0,0,1,0,1,0,0,0,0,0,0,0,0,0,0,0,0,0,0}, {1,1,1,0,0,1,0,1,1,1,1,1,1,1,1,1,1,1,0,0,0,0}, {0,0,0,0,0,1,0,0,0,0,0,0,0,0,0,0,0,1,0,0,0,0},
{0,0,0,0,0,1,1,1,1,1,1,1,1,1,1,1,1,1,0,0,0,0}, {0,0,0,0,0,0,0,0,0,0,0,0,0,0,0,0,0,0,0,0,0,0}

//Medium Map
{0,0,0,0,0,0,0,0,0,0,0,0,0,0,0,0,0,0,0,0,0,0}
{0,0,1,1,1,1,1,0,0,0,0,0,0,0,0,0,0,0,0,0,0,0}
{0,0,1,0,0,0,1,0,0,0,0,0,0,0,0,0,0,0,0,0,0,0}
{0,0,1,0,0,0,1,0,0,0,0,1,1,1,1,0,0,0,0,0,0,0}
{0,0,1,0,0,0,1,0,0,0,0,1,0,0,1,0,0,0,0,0,0,0}
{0,0,1,0,0,0,1,0,0,0,0,1,0,0,1,0,0,0,0,0,0,0}
{0,0,1,0,0,0,1,1,1,0,0,1,0,0,1,1,1,1,1,1,1,1}
{0,0,1,0,0,0,0,0,1,0,0,1,0,0,0,0,0,0,0,0,0,0}
{0,0,1,0,0,0,0,0,1,0,0,1,0,0,0,0,0,0,0,0,0,0}
{1,1,1,0,0,0,0,0,1,1,1,1,0,0,0,0,0,0,0,0,0,0}
{0,0,0,0,0,0,0,0,0,0,0,0,0,0,0,0,0,0,0,0,0,0}

//Hard Map
